00444444444400444444444400
00444444444400444444444400
44440011111100111111004444
44440011111100111111004444
44440011001100110011004444
44440011001100110011004444
44440011111100110011004444
44440011111100110011004444
44440000001100110011004444
44440000001100110011004444
44440011111100111111004444
44440011111100111111004444
44444444444444444444444444
44444444444444444444444444
55000000000055000000000055
55000000001155110000000055
22000000001111110000000022
22110011001111110011001122
22115511551111115511551122
22115511551111115511551122
22110011001100110011001122
22110011000000000011001122
22110011000000000011001122
22110011000111100011001122
22222200000130100000222200
22222200000100100000222200